S O O O O O
X O O O O O
F O O O O O
O O O O O O
O O O O O O