O O O S O O
O O X O X O
O O X O X O
O O X X X O
O O O F O O